MMMIIMMMCMMCMCMIMMMMIMMCCMMMMMMMIMMCIIMMMMCMMICMMMMMMMMIMMMMMMMMMCCMMMMIMMIMMMMCMMMMMMMMMIICIMMMMMMM
IIMMMIMMMCMMMMMMMMMMICMMIMMMMMMMMMMIMCMMMMCCMMMMIMMMMMCMMMIMMMMICMMCCIMMCICMMMMMMIMMMMMMMMMMMMIIMMMM
CMIMCMCMIIMMMMMMMMCMMMIMMMMMMCMIMIIMCMMMMMMMMIMMCMICIMIMMCIMICCMMMMMMCIIIMMCCMMMIMIMCMMMCIMCMMCIMMMM
MMMMIMMMMMMMMCMMICMCIMCMCMMCCMMMMMMIMIIIMMMMMIIMICMMMMMMMCMMMMMMMMMMMMCMMMMIMCMMMMMMMMCMMMMCMIMMMMMC
MMMMCMMMIMMMIMMMIMMMMMMMIMIMICMMMMMMMMCCMMMMCMMMIMMMMMICMCMIMIMMMMMMMMMMMMIMCMIMMMCMMMMMIMCMMMMMMMIM
MMCMMMIMIMIMMCMMMMMIMMMMMIMMCIMCMCMMMMMMCMMMMIMCCMMMIIIMCMIMMCMMMMMCMMICMMMMMMMMCMCCMIMIMMIMMMMCIIMM
MMMMMMMMMCCMMMMMIMMCIMMMMMMMMMMCCMMMMCCCMMMMCICCMMMMMMMIMMMMCMMIMMMMMMMMMMMIMMCMMMCMIMICIMIMMMMMMMMC
MCMIIICMMMCMMMMIMMMMMMMMIMCCMIMICMMCMMMCMMMMMMCMMIMCMMMMMMMMMCMMMCMMMMCMCCMMMMMMMMMMMMCMMCCMIMMMMMMM
MMMIICMMICCMIMCMCMCMMIIMCMIMMCMMMMCCMMIIMIIMMIMMCMIMCMMMMMMCCMCMMMMMIMIMMCMMMMMIMMMMMCMMMMMMIMMMMMCM
MMMMMMCMMMMCMMMMIIMMMMMMMMMCMMMIMMMMCMCMMCMMMMIMMMMIIIMMMMCMIMMCMCIMIMMMMMMIMCMCMIMMMIIMMMMMIMMMMCMM
ICMMMMMMMMCMMCMMMMMMMMMMMCCMMCMMIMMCMCIMCMMMMIMMMIIMMMMIMMIMCMMMMMMCMMMMMMMMCMMMMCMIMMMMIMMCMMCIMMCM
MMMMMCMMCMIMMMMMMCMMMMMMMIMMMMMMMMMMMMMMMMIMMMCCMIIMMMMICMMMMCMMMMMMMMMMMMIMMMCIIMMCCMMMMMMMMCIMCMMM
MMMMCMMMMMMMMMIMMCMMCCMMIMMCIMICMMMMMCCMMMMMMIMCMMMCMMCMIMIMIMMMCCMMMMCMMIMMMMMIMMMMMMCMCMIIMCMMMMMM
MMMIMIMMICMMMMMMMMMIIMCMIIIMMMMMMMMCCMMMMICMMMMCICMMMIMCMMMCMMMMMIMCMIIICCMMMMMMMMMMMMMMCMCMCMCIMMMM
MMMMMCCIMIMMCMMCMMMMMIMMCMMMIICMMMMMIMMMMMMIMMCMIICCMMMMIMMMMMCMMMMICIMIMIMMMMCMMMIIMMMMMMMMCMMCMMCC
MMMMIMMCMCMCMMMMCICIMMMMIMMMMMMCMMMIIMMMMMICCMIMMMMCMMMMMCMMIMMIIMMMMIMMMCCMMCIMIMMMMMMMMMMCMMMMMCMM
ICIMMMMMICMIMIMMMCIMCMMMMCMMMIMMIMMMMMMMMMMMIMMIMMCCMMMIMMIMMMMMMIIMMMMCCCMMIMICCCCMMMIMICMMMCMCMMMI
MMMIMMMCMMIMMMMMCCCMMCMMCMMIMIMMMMCMMMMMMMMIMMMMIMMMMMIMCMIMMMMCMCMMMMMMICMCMCMCIMIMCIMMMMMIMMMICMMM
MMMIMMMCMMMMMICMMMIMMMIMCMIMMMIMICMMMMCMMMMMMMMMMCCMMMCMCCIMIIIMMMMMMIMMMMMMMMMMMMCMIIMCMIMIICMMMCMM
IMMMMMMMMMMMIMMIMMMMMMMCMCMCMMIMIMMMMMMMMCMMIMMMICMMMMIMMIMIMMCMIMIMMMCCICMMMIMMMMIMMCMMMIMMMMCMMMMM
MMMCMMMMMIMIIIMIIMCMMMMIMMICMMMMCICMMCIMMMMMMMMMMMMMMMMMCCMICCMCMMMMMMMMCMMMMCMCIMMMMMCMIIMICMCMMMCM
CMICMMMMMCCMMMMCMCMMICMIMMIMCMIIIMMIMCMMMMMMMMIMMIMMMMMCMICMICMMIMMMMCICMMMMMMICIMMICMMMMMICCMIIMMIC
MMMMMMMMMMMMMCMCMMCMMIMCMMCMMMMIMMICCMMMMMIMCMMICMMMMMMIMMMMIMCMMMMMMCCMMIMCCMCMMCMMMMIMMMMMMMMMMMMM
MMMMMMMMMMIMMMIMMMIMMMCIMMMMMMMIIIMMMIMMMMIMMMMMMCMMMMMMMMMMCMMICCIMMMMMMIIMMCCMMMCMMMCCMMCMMMMMICCM
CMMCCMMMCMIMMCCIICIMMCIMMMMMMCMMMMMCMMMMMMMMMMCMMICMMMIMMCMCIMMMMMIMIMMIMMMMMMCMMMCMICMMMMMMMIMMMMMM
MMCMIMMMCIMIMIMMMMIMCCCCMCMMMCCMMMMMMMMMIMMMMIMMMCMMMCCMMIMMMMIMMMMMCIMMMMMMCCMCICMCMMMMMMMIMMMMMMMC
CMMICIMCCMMCCMMMMMMCMMCCCIMMIMMCMMMMMMMMMCCIIMCIIIMMMMMMIMMMMMIICMMMMMMMMMCMMMMMICMMICCMIIMMICIMMMCC
CMCMMMIMCMMMMCMMIMMMIIMMMMMMIMCMMMMMMMMMCMMMMIMMCMMMMIMMMMMMMCMICMMIIMMMCMCMCMMMCIMCMIIMMMMCMMMCMCMM
MMMCMCMIMMMMMMMMMMMMMMMMMIMMMMIMMMMMMMMMMCMMMMMIMMMICMMMMMMICMMMMMMMMMMMMMMCMMCMMMMIMMCMCMMMMMIMMMCM
MMIMMCMMMMMMMMMMMMCIMIMMMMCIMMMMMMIMMMMMCMMMMMMCIMMMMMIMMMMMMMMCMIMMMMMMMMMMICMMMMMIMMMMMIIMIMMCIIMM
CMIMMMMMMMMICCIIMMMMMCMMMIMMIMCMMMMMMIMIMCMMCCMMMMMCMMMMCMCMIIMCCCMMIMMMMIMMIMMIICMCMMCMMIIMMMCMICMC
MMMCMMIMMMIIMMMIMCMMCMCMMCIMMMMMMMMIIMCMMMMCMMMMCMCMMIICMMMMMMCCMIMIMMCMMMCMMMMMIMCIMMIMMCMMMMMMMMCM
IMMMMMMMMMMMCMCIMMMCMMIMMMCMIIIICMMMMMICIMMMMMMMMIMICMMIMMMMICMICMMIIIMCIMIMMMMMMMCMMMMIMMMMIMCMMMMM
MMMMMCMCMMMMMMMMMMMMMMIMIMIMMCIMMIMMMMMMMMMCIMMIMMMMMMIMCMIMMMMMMIMMMMMMMMMMIIMMMIMIIMMMMCMMCMMMCIMM
IMMMMMMMMMMMIICMMMCIMIMCMMMMIMMMCMCCMMMMMMMMCIMMICMMMMMMMICMMMICMMMMMMMMCMIIMMMMMIICCCIMMMMMMMCMMMMM
CCMMMMCMCMMIMMMCCICCMCMCMCIMIMIMMMMMMMCMMMIMMMMMMMMMMMMCMMCMMMMIMMMMMMMCMIIMMMMMICMIIIMMMMMMMIMMMMMM
MMIICMMMIIMMMMIMCMIMCMMCMMIMMMMIMMMMMMCMCMMMMMMIIIMICMCMMMCIIMIMMMMIMCCMIIMIMMMMIMMCMIMIMMCMMMMCMMIM
MMMMCMMMMMMMIMMMMMIMMMIIMMMMMIMMCCMMMMMMMMMMMCMIMMCMIMMCMMMCMMIMMMMIMCMMCIMMCIIMMIMMMIMMCIMMMMMMMCMI
MMIIMIICMMMMMCMMMMMMMCMCCICIMMIMCMMMIMMCMMMMMCMMIMMMMMMCMCMMMCMIMCMMMMCICMMMMMMCMMCMMMMMMMMMMMMMMIMI
IMMMCMIMMMMMCMMMMIMMMMMICMICMMIIMMMMMMMMIIMMMMIMMMMIMMMMMMCCCMMMCIMCMMMIMMMMIMMIMMIMCCMMMCMMCCMIIMMI
MIMMMCCIICMMMIIMMICMIMIMMCMMMICMMMMMMMMMMCMMMMMMIMMMIMIMIMMIMCICMMMMMIMMMCIIMMMMMMMCCMMMMMMMMIMMMMIM
CMMMIMIMMMMCMMCMMIMIIMIMMCMMMIMIIMMMMMMMMMMMMMMMCCMMMIIMMCIMMCCMMMMMCMCCMMMMMMMIIIMMMMMMICMMCCMMMMMC
MIMMCMMMIIIMICMMCIMMIMCICMMMMMMMMMMMMIIMMMMMCMMMMMMMCMMMMMMIMMMICMIIIMMCMMMMIIMMMCMCIMMMMICMMMMIMMMM
MMMMCMIMMMMMMMMMMMMMMMMIMCMMIIMMMMMMIMMMMMCMMMMIMMIICMIMMMMMIIMMMMMMIMMMCMCMMIMMMMMMMMMCMCMMMMMMICMC
MMMMMMIMMCMMMMCMMCMIMMMIMCMIMMMMMMMMMCMMMMMMMMMIIMMMMMCMIMMMMMMMIIIMCMMMICMMMCIMMMMCMMMMMMMMMMMMMMMM
MIMMMMIIMMMMMMCCMIMIIIMMMMMMMMIMIMMMIMMCMCMMCMMCIMMMCMMMMMMCMIMIMMMIMCMMMMMMMICMCMMMMCMMCMMMIMCMMMMM
ICMMMMMMMIIMMCCIIIMMMCMMMMIMMMMMMMCMMMMMMMMMMMMMMMMMMIIIMMMMMMCCMMMIIMMIICMMMMMIMIIIMCMMMMMMMMMMMIMM
MMMICMMICMCIIMMIMCCMIMMIMIMMMMMMMMMMMMMMMMMMCMMIIICCICCMMMCMMIMMMMMMMMMMMMMMMMIMMCMIIMCMIICMCCCMMIMM
CMMIIMIMMMMMCMCMMMMMMMMMMMCMMIMMMMMMMMMMCICMMMMIMIIMMMMMICMMCCMMMCMMMCICMMCMMMMMMMMMIMMMMMCMMMMMMMMM
IMCMCMIMMMMCMMMCIMIMMMMMMMMMMMMIMMMCMCMIMCMIMICIMMMMMMMCCCCMMIMMCCCMMMMMMMCMIIMMMMMMMMMMIMIMMMMMMMIM
MMMIMCMCMMMIMMMMMMMIMMIMIMMMMMMMMMMCMCMMCMMMCMMMMMCIMMIMMMMMMMMCMMMMMMCMMMMMMMMMIMMMMIMMMMMMMMMMCMMI
CMMMMMMMCMMMMMMCMMMIMCMMMIMCMMMIICMMMMMMCCCCIMMMIMMMIMCMIMMMIMMCMCCMCMICCMMCCMMMCMCMMMMMIMIMMCMMMMMM
MMMMMMMMMMCIMMCMIMCMMMMMMICMMMMMCMMCMMMMMMCIMIMMMMIMICCMCMMMCMMMMMCMMIMCCMMMMMMMCICCMMIMCMMIMMCMMMMM
CIMMMMMMMMMMMMCCMMCMMMMCMMIMMMMMCICMCMMICMMMMICMIMMMIMMMMCIMMMMMMCIMMMMMCMIMICMCMCMMMMCMMMMMMMIMMIMM
MMIMIMMMMMMCMMMMMCMMCIMMMMMCIMMCCCMMMMMMCIMMMMCMCMIMMCMCMMMIMIMMMMCMMMIMMMMMMMMMMMCMMMIMMMMMCIMMMIMM
MMCIMMMCMMMCMMMMIMCMMIIMCMCIMIMCMMMIMCMMIMIMMMMMMMMMCMMMMMICMMMMMIIMMMMMIMIMMCMCMIMMMMMMIMMIMMMMMMCM
CMMMIMIMMMMCIMMCIIMMMMMMMMCMMCMIIMMIIMMMMMCMCIMCCMMMMCMMICMCMMCMMMMCMIIIMMMMCMMMMIMCMMCIMCCMMMMMMCCM
MMCMMIMMMCIMMMMMIMMIMMMMMMMMMMCIIMMIMIICCCMICCMMMMMCMCMIMMICMMMIMMMMIMMCIMMMMMMMMIMIMMMMIMCIMMMMMMIM
MMMIMMMMCMCCIMMMCMMMMMMIMMMMMMMMIMMMMCMMMCIMMMCMMIMMICMIMMIMIMMIMCMCCMIIMMMIMMMMMIMMMMMMICMMMMMCMIMM
MCMMIMCMMMCCMIMMMCMMMIMMMMMMMMMMMMMMCMMMCMIMMMIMCMIMCMICCMMMMIMMMMMMMMMMIMMCMMMIMMMMMMMMCCMICMMICMMC
MMMCMMMMMMCMCMMMMCCMMMMMMMMCMMCMCMMMCMMMICMMMIMMMMCMMMMMMMMMIMIMMMICMIMMMMMMMMMMMMMMMMIIMMCMMMCCMCCM
MIMMCCMIMCCIMCMCMMMMMMMMMCCMIIMMICMMMMMMMMCMMMCCMMMMMCMMIMMCMMMMMMCIMCCMCCIMMMICCMMCMMMMMCMIMMMMIMMM
MMICMIMMMMIMMMICMIIIMCMMCMMMMCMMCIMMCIMMMIMMCCIICCMMMCMCMIMMIMMMIMCIMMCCMMMMMMMMMIMMCMMMMMMMMCMMMMMM
MMMMMMMMMMMMMMMMMMCMCMMCCMMMICMIMMIMMMMIMMMMMMCMMMIMCIMIMMMMMMCMIMMMMCMMCMMCMIMCMMMMMMMMMIMMMMCIMCIM
IMMMMIMCMMIMMMMMIMICCMCMMMIMIMMMMCMMMMMMMIMMMMMIMMIIIMMIMIMIMMMMMMMMCMMMMCMMMMMMMMCCMMMMMCMICMMMICMM
MMMCMIMMMMMCMIMMIMMMIMCMMIMMIMMIMCMMMMMMCMIMIMIMMCIMMMMMMMMCCMMCMIMCMMIMMMIMMMCMCMMMMMMIIMMMMMMCMMCM
MIMICMMCMMMMMMCMIMMMCIIMIMMMMMCMMMMMCMMMCMMMIMMMMMCICMMMMMMMIMMMCMCIMMMCMCCMIMMMIMMMIMCMMMIMMICIMMMI
MMMMMCIMCMIMIMMIMMMMIMMCMCMMMMMMCIMCCMMMIMMMMMMMCIMIMCMMMCMMMMIMMMMMMIICMMMIMMMMCIMMIMCMCMMMMMMMMCMM
MMMIICMMMMMMCMCMMMIMMMMMMMCIMMMMMMMMCMMMMMMMCMMIMCMCMMMMIMMMCMMMMMMMIIMCMMMMMMIIMMMMCMICMMMCMMIMCMCM
MMMMCCCMCMMMMIMMMIMICIMMMMMMCIMIMMMMMMMMMMCMCCMMMMMIIMCIMMMMICICMMMMMMMMMMMMMMIMMMMCMIMIMMIMMMMMIMII
IMMCMMMMMMMICMMMIMMIMCMMIMICCMIMMMMMMMMMMIMMMMIMMMMMMMMMIMMMMCMCMIMMIMIIMMMMMMMMMMMMMMMMMIMMCCIMMIMM
MCCIMMMCCMMMMMMMMMMMMMCMMIIMMMMMMMIMMCMIMCMMMIMCMMMMCMMMMMMIMCMMMMMMMMMMCMMMMMMMMIMMMIMMMMMMMMMCMMMM
MIMMMCMIMIICMMMMMMIMMCMIMMMMCMMMCCIMMMCMMMMMMMCMMMCMMIMMCMIIICIIMIMMMIMIMIIMMCMMCMMMMMMMMIMIMMCMMMMI
CMMMIMMCMMIIMMCIMIMMMIIIMMIMMMCIMMMIIMIMMIMMMMCMMMMMMCMIMMMIMMMIMMMIIIMIMMMMMCCMMMMCMCIIMMMCMIMCCCMM
MMMIIMMMMICCIMMMMIMCCMCMMCMCMIMMMCIIMMMMMMCMCCMCMCIMMMIIMMMMMIIMMMIMMMMCMMIIIMMMMMMMMMMMMMMMCMCMIMMM
CMMMMMMMMMCMIMMMCMMMMMMMMMMMMMMMMCMCCMMMICMMMMMIMMMCCIMMMMMCIMCCMCIMMMMCMCMMICCMMMICMMMIMMMMIMMMMMIM
MIMMIMMMMCICMMCIMMCMMMMMMCMMMMMMCMCMMMMMMIIMMMIIMCCMMCMMMMMMIMMMIMMMMMMMMMMIMCMMMMCIMMCIMMMCMIMMMIMM
ICCIMMIMMCICIMMCMMMMMMCCIMMIMMMCCMMCMMMIIMMICICMMIMIMMMMMICMIMMMMMMCIICCMMMMMCMMMMCMMMMMMIMMMMCMCMMM
MMMIMIMIIMMMMMMMMMMMMMMMMMCMMMMMICMIICICMMMMCIMCCMMMMCMMCIMMMMMIIIMCMMMMMIIMCMCMMMMIMMIICMICMMMMMMMM
MMMCCMMIIMMMMIMMCMIMIMMCMMMCMCMMMIIMMMMMMMMIMMMMMMMMMCMMCCIMMMMCCCCIMMMMCCMIIMCMIMCMMMMMMMMCMMIMIMCM
MMMIMIIMMMMMIMMMMMMMCMMIMMMCMMMMMMIMMMMMMCMMMCMMMMMMMCCMMMMMMMMCMMIIMIMMMMMMIMIIMMMCMCMMMIMMIMMMCIII
MMMMCCMCMIMMIMIMMMMMMIMCICMMMCMMCIMMMMMMIMICMMMIIMMCCMIMMMMMMMMMMMMMMMMCMMICMMMMMMMMMCICMIMMMMMCMMCM
MMCMMMCMMMMMMMMCIMMMMIMMMMMMMMCMMMIIMMMCIMMMMMMMICMMIMMCMMMCCMICMMMMMIMMMMMMIMMMIIMCMMCMMIIIIMMMMMMC
CMCMMCIMICMMICICMMCCMIMICMIIMMIMMMMMMMMCMCMIMIMMMMMMICCMMMMMCMMMIIMIMMMMIIIMIMIMCCICMMMMCIMIMMMMIMMM
CICMCMCMMMIMMMMMMMMIMMMMMMIMMMMCMCMMMMMCIMMMMCMIMMMMMMMMMMIMCMICCMMIMIMMMIMMCMMMMMMMMIMMMMMMMMMMMCMM
MMMMMMMCMMMCMCMMCMMMCICCMMMMMMMMMIMMMMMMMMMCMMMCIIMMMMMMCCMMMMMMCMMMCIMMMMMMIMMMMMIMCMMMMMMMMMMMMCIM
MMMMIMMMCMMIMCCCMMMMMIMMIMMCMMMMMMMMMMMCMMMMMMIMMIMMMMIIMMMMIMCMMIMCMMMMCMMMMICMMMMMIMCIMIMMMMIMCMMM
IMMCCMCMIMMIMMMCIMCMMIMCMMMIMMCMCMMMMIMIMMCCMMMCMMMMIMMICMIMMMMMMMCMMMMIMMMMMMMCMCMMMMMMMMCMCICCMIIM
MIMMCMCCMMIICMMIMMMCMIIMIMIMMCCCMMMMMMMMMMMIIMMMCIMMMMMCMMMIMMIMMMIMMMMMCMMCMCMIIMIMCCMMMMMMMCMMMIIM
MMMIMCMIMMMCICMCIMMMMMMMCICMMMMIMMMMMMMMMMMMICMMCCIMIMMMCCCMMMMIMMCMMMCMCIMCIMMMMIMMIMMMMIMMMCIMMIMM
CMIMMMCMMCMMMMCMMMCMMIMIMMMMMMMMICMMMMICMMMMMCMMIMMMMMMMCMMCMMMMCMIICMMMMMMMICMIIMMMICMMMMMMMCIMMIMC
MMMMMMCMMMMMMMCCCMMIMMCIIMCMCCIMMMIMMIMMMIIMIMCMMMCICMMMMMMMIMIMCMMCMMMMIMMMCICMMMMCIMCMMMMMCMIMIMMM
MIMMIMMIMMICMMMMIMMIMMCIMCMMMMMMMCMMMMMMMMICMMCIMMMMMMMMMIMMMCMMMMMMCCCIIMMMMMMICIMIMMMMMMMMMMMMIMMM
MMMMMMCMMIMCMCMMMMMMMMCMMMMMMMMICIIIMMIMMCMMCICMMMCMMMMMIMIMMCMMCMMIMMMICMCMIMMMMMMCMMMMMMMMMMMMMMMM
IMIMMCMMMICMMMMMCIICMMMMMMIMIIMMMMMMMMCCMMMMMCMMMMMMMCMMMMMCCCIMMIMMIMMMCCMMCMMMIMMMMMMMCMMMMMCIMMII
MMMICMMMMCMMMCMIMMIMCMMMIMMCMMMMMIMICCIMMICMMCMMCMMMMCMMMIMIMMMCMMMIMMMMIMMICMCMMMMMMMIIMMCMMMMMMMIM
MMMMMMMIMMIIMMMMCMMMMCMMMMMMIMMIMCICMMIMMCMIMMMMMMMIMCCIMMCMCMMCIMCMMMIMIMMMMIMMMMCMMCMMCMMMCMMMMIIM
MIMMIMMMMMMMCMMIMMMMIIMMMMMCMMCMMCMMMIMMMIMMICCMMMMMMMMMMCMMICMCICMMMMMCMMCMMMCCMMICMMMMMMMMMMCIMMIM
MCMCCMMMMMIIMMIMMMIMMMCMMMMMIMMMMMMMMMIMMMMMMMCMMMCMMIMMMCIMMMCMMMIMCMMIMMICMMMIMMMMMMMICMIMCCIMMMIM
MMMMMMCCMMIMMMMMMMIMMMMMMMMMCCMMMMMIMMMIMMMMMMCMMMMCMMMIMMMMMCIMMMMICCCMIMMMMIMMMCCCMMMMIIIMMIMIMMMC
